8 8
********
*   *  *
* ***  *
* *    *
* ** * *
*    * *
* **   *
********
1 2 1 5
