20 15
***************
*    *        *
* ****** **** *
*      *     **
** ***   ******
*    * *     **
** ****** **  *
*         **  *
* **** *   * **
*      **     *
*** ** ***  ***
*   *  **     *
* *** **** ** *
*       *  *  *
** ****    * **
*     **  *****
*  **  *    * *
*    * * ** * *
*  *      *   *
***************
1 3 17 11
