20 18
******************
*    *           *
* ****** **   ** *
*      *    *    *
** ***   *  ******
*    * *  *     **
** ****** * ***  *
*         *  **  *
* * * **  ***** **
*   *  **        *
*** ** *** *** ***
*   *  *   *     *
* *** **** ** ** *
*       *  *  *  *
** ****    * ** **
*     ** *** *****
* ***  *  *   *  *
*   ** * ** * ** *
* *       * *    *
******************
1 3 18 17
