20 10
**********
*    *   *
* ****** *
*       **
** **   **
*    *  **
*  **    *
*        *
* **    **
* *      *
* **** ***
*    *   *
* *****  *
*        *
** **   **
*    *  **
*  **    *
*        *
*  *    **
**********
1 3 17 8
