30 10
**********
*    *   *
* ****** *
*      ***
** **   **
*   **  **
*  **    *
*      * *
* ** * ***
* *  *   *
* **** ***
*    *   *
* *****  *
*        *
** ***  **
*    *  **
*  **    *
*     *  *
*  **** **
**       *
*  *** ***
*    *   *
**  ***  *
*        *
** **** **
*    *  **
*  ***   *
*        *
*  *    **
**********
1 3 27 8