9 10
**********
*    *   *
* ****** *
*       **
** **   **
*    *  **
*  **    *
*         
**********
0 1 7 9
