9 10
**********
*     *  *
* ****** *
*       **
** **   **
*    *  **
*  **    *
*        *
**********
6 7 6 7
